[XSize]  20
[YSize]  16

[Picture]
  255  255  255  255  255  255  255  255  255  255  255  255  255  255
  255  255  255  255  255  255  255  255  255  255  255  255  255  255
  255  255  255  255  255  255  255  255  255  255  255  255  255  255
   27   27   27   27   27  255  255  255  255  255  255   27   27   27
   27  255  255  255  255  255   27   28    7   28   28   27  255  255
   27   27   27   28   28   28   28   27  255  255  255  255   27    7
    7    7   28   28   27   27   28   28   28   11   28   11   28   27
  255  255  255  255   27   28    7    7   28   28   28   28   13   13
   13   13   11   28   28   27  255  255  255  255  255   27   28    7
   28   28   28   13   28   28   28   11   28   11   27  255  255  255
  255  255  255   27   28   28   28   28   13   28   28   28   28   28
   28   28   28   27  255  255  255  255  255   27   28   28   28   13
   28   28   28   28   28   28   28   28   28   28   27  255  255  255
   27   28   28   28   13   28   28   28   28   28   28    3    3   28
   28   28   27  255  255  255   27   28   28   13   28   28   28   28
   28   28    3    3    3    3   28   28   27  255  255  255   27   28
   28   28   28   28   28   28   28   28   28    3    3   28   28   27
  255  255  255  255   27   28   28   28   28   28   28   28   27   27
   27   28   28   28   28   27  255  255  255  255   27   28   28   27
   27   27   27   27  255  255  255   27   27   27   27  255  255  255
  255  255  255   27   27  255  255  255  255  255  255  255  255  255
  255  255  255  255  255  255  255  255  255  255  255  255  255  255
  255  255  255  255  255  255  255  255  255  255  255  255

[Palette]
  3 =  LightBlue
  7 =  MediumGreen
 11 =  DarkRed
 13 =  LightRed
 27 =  LightGold
 28 =  Blank
